Usernames:
Gmail:       "Username:"            <id=Email name=Email>
Reddit:      "username:"            <name=user>
Mail.Yahoo:  "Yahoo! ID:"           <id=username name=login>
eBay:        "eBay User ID:"        <name=userid>
NetZero Vc:  "Member ID:"           <name=MemberID>
e-e:         "Login:"               <name=msuLoginName>
Wordpress:   "Name (required)"      <id=author name=author>  LABEL AFTER
             "Mail (will not..)"    <id=email name=email>
Sourceforge: "Username:"            <name=form_loginname>
YouTube:     "User Name:"           <name=username>
WikiPedia:   "Username:"            <id=wpName1 name=wpName>
Drupal:      "Username: *"          <id=edit-name name=edit[name]>
Blogger:     "Username:"            <id=signin-u name=username>
Slickdeals:  "User Name"            <id=navbar_username name=vb_login_username>
newegg.com:  "Newegg.com ID"        <name=txtLoginName>
             "(Usually your Email Address)" LABEL AFTER
backpackit:  "Username:"            <id=username name=username>
digg:        "Username:"            <id=side-username name=side-username>
last.fm:     "Username:"            <id=username name=username>
stumbleupon: "Username"             <name=username>
photobucket: "Username"             <id=username name=username>
Skype:       "Skype Name"           <id=skype-name name=username>
typekey:     "Member name:"         <id=name name=name>
phpclasses:  "Access name:"         <id=alias name=alias>

Emails:
Google Spreadsheets: "Email:"       <id=Email name=Email>
Myspace:     "E-Mail:"              <id=email name=email>
mybloglog:   "Email Address:"       <id=userName name=userName>
Bloglines:   "Email Address"        <id=txt_email name=email>
craigslist:  "Email / Handle:"      <name=inputEmailHandle>
Hotmail:     "E-mail address:"      <id=i0116 name=login>
Stanaphone:  "E-mail:"              <id=e name=e>
Amazon:      "My e-mail address is" <name=email>
a.m.org:     "E-mail:"              <name=email>


Other/Both:
Meebo:
   AIM:      "Screen Name:"         <id=aim>
   Yahoo:    "Yahoo! ID:"           <id=yahoo>
   Jabber:   "Screen Name:"         <id=jabber>
   MSN:      "Email:"               <id=msn>
Basecamp:    "Email Address:"       <name=account_holder[email_address]>
 (register)  "Username:"            <name=account_holder[user_name]>
